OOOOOOOOOO
##########
#X%gggggt#
###     g#
#m   C  g#
#    g  g#
#OS     g#
#    s  g#
#tggggggE#
OOOOOOOOOO