OOOOOOOOOO
##########
#X%   t b#
### s   g#
#m  g b g#
#   gC  g#
#OS O   g#
#   C   g#
#tggggggE#
OOOOOOOOOO