##########
#   X   X#
#   b    #
#   C  t #
#   t    #
#      # #
#  C   #C#
#     O# #
#  X   #E#
##########