##########
#b  X   X#
#        #
#   C    #
#        #
#      # #
#  C P #C#
#     O# #
#  X   #E#
##########