OOOOOOOOOO
O#########
O#XX X   #
O# #     #
O#C  #####
O#  C    #
O# C     #
O#  E    #
O#########
OOOOOOOOOO

