##########
#b  X   X#
#        #
#   C  t #
#   t    #
#      # #
#  C   #C#
#     O# #
#  X   #E#
##########